XXXXXXXXXXXXXXXXXXX
X         X       X
X X XXXXX X XXXXX X
X X X   X X X   X X
X X X X X X X X X X
X X   X X   X X   X
X XXXXX XXX X XXXXX
X   X       X     X
XXX X XXX XXXXX X X
X     X       X X X
X XXXXX XXXXX X X X
X       X     X   X
XXX X XXX XXXXX XXX
X   X   X       X X
X XXX X X XXX XXX X
X X   X X   X     X
X X X X XXX XXXXX X
X   X X           X
XXXXXXXXXXXXXXXXXXX
